################
#......#.#...#.#
#.####...#.#.#.#
#..#.#.#.#.#...#
##.#...#.#.###.#
##.#####.#.#.#.#
+..#...#.###...#
####.#.#...#.#.#
#.##.#.###...#.#
#.####...###.#.#
#......#.....#.#
##############+#
